NNNNNNNNNNNNNNNNNNNNNNNNNNNNNNNNNNNNNNNNNNNNNNNNNNNNNNNNNNNNNNNNNNNNNNNNNNNNNNNNNNNNNNNN
NNOOOOOOONNOONNOOOOOOOOONNOOONNOONNOOOOOOOOOOOOOOOOOONNOONNOOONNOOOOOOOOONNOONNOOOOOOONN
NNUUUUUUZQQUZNNUUUUUUUUZQQUUZNNUZNNUUUUUUUUUUUUUUUUUZNNUZNNUUZQQUUUUUUUUZNNUZQQUUUUUUZNN
NNEEEEEEXPPEXNNEEEEEEEEXPPEEXNNEXNNEEEEEEEEEEEEEEEEEXNNEXNNEEXPPEEEEEEEEXNNEXPPEEEEEEXNN
NNEEEEEETUVEXNNNNNNNNQETUVEEXNNEXNNNQEEYQQEEEYQQEEYQNNNEXNNEETUVEYQNNNNNNNNETUVEEEEEEXNN
NNEEEEEWEEEEXNSSSSSSSNEEEEEEXNNEXQNNQEEXNNEEEXNNEEXQNNQEXNNEEEEEEXNSSSSSSSNEEEEEEEEEEXNN
NNEEEEEEEEEEXNSSSSSSSNEEEEEEXNNEXPOOPEEXNNEEEXNNEEXPOOPEXNNEEEEEEXNSSSSSSSNEEEEEEEEEEXNN
NNEEEEEEYQQEXNSSSSSSSNEYQQEEXNNETUUUVEEXNNNNNNNNEETUUUVEXNNEEYQQEXNSSSSSSSNEYQQEEEEEEXNN
NNEEEEEEXNNEXNSSSSSSSNEXNNEEXNNEEEEEEEEXNNOOOONNEEEEEEEEXNNEEXNNEXNSSSSSSSNEXNNEEEEEEXNN
NNNQEEYQNNQEXQNNNNNNNQEXNNEEXQNNNNQEYQNNNQUUUZQNNNQEYQNNNNQEEXNNEXQNNNNNNNQEXQNNQEEYQNNN
NNOPEEXPOOPEXPOOOOOOOPEXNNEEXPOOOOPEXNSNOPEEEXPONSNEXPOOOOPEEXNNEXPOOOOOOOPEXPOOPEEXPONN
NNUVEETUUUVETUUUUUUUUVEXNNEETUUUUUVEXQNQUVEEETUZQNQETUUUUUVEEXNNETUUUUUUUUVETUUUVEETUZNN
NNEEEEEEEEEEEEEEEEEEEEEXNNEEEEEEEEEEXPOPEEEWEEEXPOPEEEEEEEEEEXNNEEEEEEEEEEEEEEEEEEEEEXNN
NNEEEEEEYQNNNNNNNNNQEYQNNNNNNNQEYQQETUUVEEEEEEETUUVEYQQEYQNNNNNNNQEYQNNNNNNNNNQEYQNQEXNN
NNEYQNQEXPOOOOOOOOOPEXNNOOOOONNEXNNEEEEEEEEEEEEEEEEEXNNEXNNOOOOONNEXPOOOOOOOOOPEXNSNEXNN
NNEXNSNETUUUUUUUUUUVEXNNUUUUZNNEXNNEEYQNNNNNNNNNNQEEXNNEXNNUUUUZNNETUUUUUUUUUUVEXNSNEXNN
NNEXNSNEEEEEEWEEEEEEEXNNEEEEXNNEXNNEEXQNNNNSSNNNNQEEXNNEXNNEEEEXNNEEEEEEEEEEEEEEXNSNEXNN
NNEXNSNEEEEEEEEEEEEEEXNNEEEEXNNEXNNEEXPOOONSSNOOOPEEXNNEXNNEEEEXNNEEEEEEEEEEEEEEXNSNEXNN
NNEXNSNNNNNNNNQEEYQNNNNNNQEEXQQEXNNEETUUUZNSSNUUUVEEXNNEXQQEEYQNNNNNNQEEYQNNNNNNNNSNEXNN
NNEXNSSSSSNOOOPEEXPOOOOOOPEEXPPEXNNEEEEEEXNSSNEEEEEEXNNEXPPEEXPOOOOOOPEEXPOOONSSSSSNEXNN
NNEXNSSSSSNUUUVEETUUUUUUUVEETUVEXNNNNNNQEXQNNQEYQNNNNNNETUVEETUUUUUUUVEETUUUZNSSSSSNEXNN
NNEXNSSSSSNEEEEEEEEEEEEEEEEEEEEEXNNOOOOPEXPOOPEXPOOOONNEEEEEEEEEEEEEEEEEEEEEXNSSSSSNEXNN
NNEXQNNNNNQEYQQEEYQNNNNQEYQNNNQEXQQUUUUVETUUUVETUUUUZQQEYQNNNQEYQNNNNQEEYQQEXQNNNNNQEXNN
NNEXPOOOOOPEXNNEEXPOOOOPEXPOONNEXPPEEEEEEEEEEEEEEEEEXPPEXNNOOPEXPOOOOPEEXNNEXPOOOOOPEXNN
NNETUUUUUUVEXNNEETUUUUUVETUUZQQETUVEYQNQEYQNNQEYQNQETUVEXQQUUVETUUUUUVEEXNNETUUUUUUVEXNN
NNEEEEEEEEEEXNNEEEEEEEEEEEEEXPPEEEEEXNSNEXNSSNEXNSNEEEEEXPPEEEEEEEEEEEEEXNNEEEEEEEEEEXNN
NNEYQNNNNNQEXNNNQEEYQNNQEEEETUVEEEEEXNSNNNNSSNNNNSNEEEEETUVEEEEYQNNQEYQNNNNEYQNNNNNQEXNN
NNEXNSSSSSNEXNNNQEEXNSSNEEEEEEEEEEEEXNSNNNNNNNNNNSNEEEEEEEEEEEEXNSSNEXQNNNNEXNSSSSSNEXNN
NNEXNSSSSSNEXNNOPEEXNSSNEEEEEEEEEEEEXNSNOOOOOOOONSNEEEEEEEEEEEEXNSSNEXPOONNEXNSSSSSNEXNN
NNEXQNNNNNQEXQQUVEEXNSSNEYQNNNNNQEEEXQNQUUUUUUUZQNQEEEYQNNNNNQEXNSSNETUUZQQEXQNNNNNQEXNN
NNEXPOOOOOPEXPPEEEEXNSSNEXNSSSNOPEEEXPOPEEEEEEEXPOPEEEXPONSSSNEXNSSNEEEEXPPEXPOOOOOPEXNN
NNETUUUUUUVETUVEEEEXNSSNEXNSSSNUVEEETUUVEEEEEEETUUVEEETUZNSSSNEXNSSNEEEETUVETUUUUUUVEXNN
NNEEEEEEEEEEEEEEEEEXNSSNEXNSSSNEEEEEEEEEEEEEEEEEEEEEEEEEXNSSSNEXNSSNEEEEEEEEEEEEEEEEEXNN
NNEEEEEEEEEEEEEEEEEXNSSNEXNSSSNEEEWEEEEEEEEEEEEEEEEEEEEEXNSSSNEXNSSNEEEEEEEEEEEEEEEEEXNN
NNEEEEEEEEEEEEEEEEEXNSSNEXNSSSNEEEEEEEEEEEEEEEEEEEEEEEEEXNSSSNEXNSSNEEEEEEEEEEEEEEEEEXNN
NNEYQNNNNNQEYQQEEEEXNSSNEXQNNNNNQEEEYQNQEEEEEEEYQNQEEEYQNNNNNQEXNSSNEEEEYQQEYQNNNNNQEXNN
NNEXNSSSSSNEXNNEEEEXNSSNEXPOOOOOPEEEXNSNEEEEEEEXNSNEEEXPOOOOOPEXNSSNEEEEXNNEXNSSSSSNEXNN
NNEXNSSSSSNEXNNNQEEXNSSNETUUUUUUVEEEXNSNNNNNNNNNNSNEEETUUUUUUVEXNSSNEYQNNNNEXNSSSSSNEXNN
NNEXQNNNNNQEXNNNQEEXQNNQEEEEEEEEEEEEXNSNNNNNNNNNNSNEEEEEEEEEEEEXQNNQEXQNNNNEXQNNNNNQEXNN
NNEXPOOOOOPEXNNOPEEXPOOPEEEEEEEEEEEEXNSNOONSSNOONSNEEEEEEEEEEEEXPOOPEXPOONNEXPOOOOOPEXNN
NNETUUUUUUVEXNNUVEETUUUVEYQNNNQEYQQEXQNQUZQNNQUZQNQEYQQEYQNNNQETUUUVETUUZNNETUUUUUUVEXNN
NNEEEEEEEEEEXNNEEEEEEEEEEXPOONNEXNNEXPOPEXPOOPEXPOPEXNNEXNNOOPEEEEEEEEEEXNNEEEEEEEEEEXNN
NNEYQNNNNNQEXQQEEYQNNNNQETUUZQQEXNNETUUVETUUUVETUUVEXNNEXQQUUVEYQNNNNQEEXQQEYQNNNNNQEXNN
NNEXNSSSSSNEXPPEEXPOOOOPEEEEXPPEXNNEEEEEEEEEEEEEEEEEXNNEXPPEEEEXPOOOOPEEXPPEXNSSSSSNEXNN
NNEXNSSSSSNETUVEETUUUUUVEEEETUVEXNNNNNNQEYQNNQEYQNNNNNNETUVEEEETUUUUUVEETUVEXNSSSSSNEXNN
NNEXNSSSSSNEEEEEEEEEEEEEEEEEEEEEXNNOOOOPEXNSSNEXPOOOONNEEEEEEEEEEEEEEEEEEEEEXNSSSSSNEXNN
NNEXNSNNNNNNNNQEEYQNNNNNNQEEYQQEXNNUUUUVEXNSSNETUUUUZNNEYQQEEYQNNNNNNQEEYQNNNNNNNNSNEXNN
NNEXNSNOOOOOOOPEEXPOOONNOPEEXNNEXNNEEEEEEXNSSNEEEEEEXNNEXNNEEXPONNOOOPEEXPOOOOOOONSNEXNN
NNEXNSNUUUUUUUVEETUUUZNNUVEEXNNEXNNEYQNNNNNSSNNNNNQEXNNEXNNEETUZNNUUUVEETUUUUUUUZNSNEXNN
NNEXNSNEEEEEEEEEEEEEEXNNEEEEXNNEXNNEXQNNNNNNNNNNNNQEXNNEXNNEEEEXNNEEEEEEEEEEEEEEXNSNEXNN
NNEXQNQEEEEEEEEEEEEEEXNNEEEEXNNEXNNEXPOOOOOOOOOOOOPEXNNEXNNEEEEXNNEEEEEEEEEEEEEEXQNQEXNN
NNEXPOPEYQNNNNNNNNNQEXQNNNNNNNQEXQQETUUUUUUUUUUUUUVEXQQEXQNNNNNNNQEYQNNNNNNNNNQEXPOPEXNN
NNETUUVEXPOOOOOOOOOPEXPONNOOOOPEXPPEEEEEEEEEEEEEEEEEXPPEXPOOOONNOPEXPOOOOOOOOOPETUUVEXNN
NNEEEEEETUUUUUUUUUUVETUZNNUUUUVETUVEYQNQEEEEEEEYQNQETUVETUUUUZNNUVETUUUUUUUUUUVEEEEEEXNN
NNEEEEEEEEEEEEEEEEEEEEEXNNEEEEEEEEEEXNSNEEEEEEEXNSNEEEEEEEEEEXNNEEEEEEEEEEEEEEEEEEEEEXNN
NNNQEEYQNNQEYQNNNNNNNQEXNNEEYQNNNNQEXQNNNQEEEYQNNNQEYQNNNNQEEXNNEYQNNNNNNNQEYQNNQEEYQNNN
NNOPEEXPONNEXNSSSSSSSNEXNNEEXNNOOOPEXPOONNEEEXNNOOPEXPOOONNEEXNNEXNSSSSSSSNEXNNOPEEXPONN
NNUVEETUZQQEXNSSSSSSSNEXQQEEXNNUUUVETUUZNNNNNNNNUUVETUUUZNNEEXQQEXNSSSSSSSNEXQQUVEETUZNN
NNEEEEEEXPPEXNSSSSSSSNEXPPEEXNNEEEEEEEEXNNOOOONNEEEEEEEEXNNEEXPPEXNSSSSSSSNEXPPEEEEEEXNN
NNEEEEEETUVEXNSSSSSSSNETUVEEXNNEYQNNQEEXNNUUUZNNEEYQNNQEXNNEETUVEXNSSSSSSSNETUVEEEEEEXNN
NNEEEEEEEEEEXNNNNNNNNQEEEEEEXNNEXNNNQEEXQQEEEXQQEEXQNNNEXNNEEEEEEXQNNNNNNNNEEEEEEEEEEXNN
NNEEEEEEEEEEXNNOOOOOOPEEEEEEXNNEXNNOPEEXPPEEEXPPEEXPONNEXNNEEEEEEXPOOOOOONNEEEEEEEEEEXNN
NNEEEEEEYQQEXNNUUUUUUVEYQQEEXNNEXNNUVEETUVEEETUVEETUZNNEXNNEEYQQETUUUUUUZNNEYQQEEEEEEXNN
NNEEEEEEXNNEXNNEEEEEEEEXNNEEXNNEXNNEEEEEEEEEEEEEEEEEXNNEXNNEEXNNEEEEEEEEXNNEXNNEEEEEEXNN
NNNNNNNNNNNNNNNNNNNNNNNNNNNNNNNNNNNNNNNNNNNNNNNNNNNNNNNNNNNNNNNNNNNNNNNNNNNNNNNNNNNNNNNN
SSSSSSSSSSSSSSSSSSSSSSSSSSSSSSSSSSSSSSSSSSSSSSSSSSSSSSSSSSSSSSSSSSSSSSSSSSSSSSSSSSSSSSSS