OOOOOOOOOOOOOOOOOOOOOOOOOOOOOOOOOOOOOOOOOOOO
OEEEOOEOEEEEOEOEOOEEEEEEEEOOEOEOEEEEOEOOEEEO
OEEEEEEOOOOEEEOEOOOEOEEOEOOOEOEEEOOOOEEEEEEO
OEEEEEEOOOOEOEOEEEEEOOOOEEEEEOEOEOOOOEEEEEEO
OOEEOOEOOOOEOEOOOEEOOEEOOEEOOOEOEOOOOEOOEEOO
OOEEOEEOOOOEOEEOOEEOEEEEOEEOOEEOEOOOOEEOEEOO
OEEEEEEEEEEEOOEEEEEEEEEEEEEEEEOOEEEEEEEEEEEO
OEOEEOOOOOEOOOOEOOEEEEEEEEOOEOOOOEOOOOOEEOEO
OEOEEEEEEEEOEEOEOOEOOOOOOEOOEOEEOEEEEEEEEOEO
OEOOOOOOEOOOOEOEOOEEEOOEEEOOEOEOOOOEOOOOOOEO
OEOOOOEEEEEEEEEEOOOOEOOEOOOOEEEEEEEEEEOOOOEO
OEOOOOEOEOOOEOOEOOEEEEEEEEOOEOOEOOOEOEOOOOEO
OEEEEEEOEEEEEEOEEEEOEOOEOEEEEOEEEEEEOEEEEEEO
OEOOOEEOOEOOEEEEEEEOOOOOOEEEEEEEOOEOOEEOOOEO
OEOOOOEOEEOOEOOOEEEOEEEEOEEEOOOEOOEEOEOOOOEO
OEEEEEEEEEOOEOOOEEEEEEEEEEEEOOOEOOEEEEEEEEEO
OEEEEEEEEEOOEOOEEEEEEEEEEEEEEOOEOOEEEEEEEEEO
OEEEEEEEEEOOEOOOEEEEEEEEEEEEOOOEOOEEEEEEEEEO
OEOOOOEOEEOOEOOOEEEOEEEEOEEEOOOEOOEEOEOOOOEO
OEOOOEEOOEOOEEEEEEEOOOOOOEEEEEEEOOEOOEEOOOEO
OEEEEEEOEEEEEOOEOOEOEOOEOEOOEOOEEEEEOEEEEEEO
OEOOOOEOEOOOEEOEOOEEEEEEEEOOEOEEOOOEOEOOOOEO
OEOOOOEEEEEEEEEEOOOOEOOEOOOOEEEEEEEEEEOOOOEO
OEOOOOOOEOOOOEOEOOEEEOOEEEOOEOEOOOOEOOOOOOEO
OEOEEEEEEEEOEEOEOOEOOOOOOEOOEOEEOEEEEEEEEOEO
OEOEEOOOOOEOOOOEOOEEEEEEEEOOEOOOOEOOOOOEEOEO
OEEEEEEEEEEEOOEEEEEEEEEEEEEEEEOOEEEEEEEEEEEO
OOEEOEEOOOEEOEEOOEEOEEEEOEEOOEEOEEOOOEEOEEOO
OOEEOOEOOOOEOEOOOEEOOEEOOEEOOOEOEOOOOEOOEEOO
OEEEEEEOOOOEOEOEEEEEOOOOEEEEEOEOEOOOOEEEEEEO
OEEEEEEOOOOEEEOEOOOEOEEOEOOOEOEEEOOOOEEEEEEO
OEEEOOEOEEEEOEOEOOEEEEEEEEOOEOEOEEEEOEOOEEEO
OOOOOOOOOOOOOOOOOOOOOOOOOOOOOOOOOOOOOOOOOOOO
