OOOOOOOOOOOOOOOOOOOOOOOOOOOOOOOOOOOOOOOOOOOOOOOOOOOOOOOOOOOOOOOOOOOOOOOOOOOOOOOOOOOOOOOO
OOOOOOOOOOOOOOOOOOOOOOOOOOOOOOOOOOOOOOOOOOOOOOOOOOOOOOOOOOOOOOOOOOOOOOOOOOOOOOOOOOOOOOOO
OOEEEEEEEOOEEOOOEEEEEEEEOOOEOOOEEOOEEEEEEEEEEEEEEEEEEOOEEOOOEOOOEEEEEEEEOOOEEOOEEEEEEEOO
OOEEEEEEEOOEEOOEEEEEEEEEOOEEEOOEEOOEEEEEEEEEEEEEEEEEEOOEEOOEEEOOEEEEEEEEEOOEEOOEEEEEEEOO
OOEEEEEEEEEEEOOOOOOOOOEEEEEEEOOEEOOOOEEEOEEEEEEOEEEOOOOEEOOEEEEEEEOOOOOOOOOEEEEEEEEEEEOO
OOEEEEEEEEEEEOOOOOOOOOEEEEEEEOOEEOOOOEEEOOEEEEOOEEEOOOOEEOOEEEEEEEOOOOOOOOOEEEEEEEEEEEOO
OOEEEEEEEEEEEOOOOOOOOOEEEEEEEOOEEOOOOEEEOOEEEEOOEEEOOOOEEOOEEEEEEEOOOOOOOOOEEEEEEEEEEEOO
OOEEEEEEEOOEEOOOOOOOOOEEOOEEEOOEEEEEEEEEOOOOOOOOEEEEEEEEEOOEEEOOEEOOOOOOOOOEEOOEEEEEEEOO
OOEEEEEEEOOEEOOOOOOOOOEEOOEEEOOEEEEEEEEOOOOOOOOOOEEEEEEEEOOEEEOOEEOOOOOOOOOEEOOEEEEEEEOO
OOOOEEEOOOOEEOOOOOOOOOEEOOEEEOOOOOOEEOOOOOEEEEOOOOOEEOOOOOOEEEOOEEOOOOOOOOOEEOOOOEEEOOOO
OOOOEEEOOOOEEOOOOOOOOOEEOOEEEOOOOOOEEOOOOOEEEEOOOOOEEOOOOOOEEEOOEEOOOOOOOOOEEOOOOEEEOOOO
OOEEEEEEEEEEEEEEEEEEEEEEOOEEEEEEEEEEEOOOEEEEEEEEOOOEEEEEEEEEEEOOEEEEEEEEEEEEEEEEEEEEEEOO
OOEEEEEEEEEEEEEEEEEEEEEEOOEEEEEEEEEEEOOOEEEEEEEEOOOEEEEEEEEEEEOOEEEEEEEEEEEEEEEEEEEEEEOO
OOEEEOEEEOOOOOOOOOOOEEOOOOOOOOOEEOOEEEEEEEEEEEEEEEEEEOOEEOOOOOOOOOEEOOOOOOOOOOOEEEOEEEOO
OOEEOOOEEOOOOOOOOOOOEEOOOOOOOOOEEOOEEEEEEEEEEEEEEEEEEOOEEOOOOOOOOOEEOOOOOOOOOOOEEOOOEEOO
OOEEOOOEEEEEEEEEEEEEEEOOOEEEOOOEEOOEEEOOOOOOOOOOOOEEEOOEEOOOEEEOOOEEEEEEEEEEEEEEEOOOEEOO
OOEEOOOEEEEEEEEEEEEEEEOOEEEEEOOEEOOEEOOOOOOOOOOOOOOEEOOEEOOEEEEEOOEEEEEEEEEEEEEEEOOOEEOO
OOEEOOOEEEEEEEEEEEEEEEOOOEEEEOOEEOOEEEOOOOOOOOOOOOEEEOOEEOOEEEEOOOEEEEEEEEEEEEEEEOOOEEOO
OOEEOOOOOOOOOOOEEEOOOOOOOOEEEOOEEOOEEEEEEEOOOOEEEEEEEOOEEOOEEEOOOOOOOOEEEOOOOOOOOOOOEEOO
OOEEOOOOOOOOOOOEEEOOOOOOOOEEEOOEEOOEEEEEEEOOOOEEEEEEEOOEEOOEEEOOOOOOOOEEEOOOOOOOOOOOEEOO
OOEEOOOOOOOEEEEEEEEEEEEEEEEEEEEEEOOOOOOOEEOOOOEEOOOOOOOEEEEEEEEEEEEEEEEEEEEEEOOOOOOOEEOO
OOEEOOOOOOOEEEEEEEEEEEEEEEEEEEEEEOOOOOOOEEOOOOEEOOOOOOOEEEEEEEEEEEEEEEEEEEEEEOOOOOOOEEOO
OOEEOOOOOOOEEOOEEEOOOOOOEEOOOOOEEOOEEEEEEEEEEEEEEEEEEOOEEOOOOOEEOOOOOOEEEOOEEOOOOOOOEEOO
OOEEOOOOOOOEEOOEEEOOOOOOEEOOOOOEEOOEEEEEEEEEEEEEEEEEEOOEEOOOOOEEOOOOOOEEEOOEEOOOOOOOEEOO
OOEEEEEEEEEEEOOEEEEEEEEEEEEEOOOEEEEEEEOEEEOOOOEEEOEEEEEEEOOOEEEEEEEEEEEEEOOEEEEEEEEEEEOO
OOEEEEEEEEEEEOOEEEEEEEEEEEEEEOOEEEEEEOOOEEOOOOEEOOOEEEEEEOOEEEEEEEEEEEEEEOOEEEEEEEEEEEOO
OOEEEOOOOOOEEOOOOEEEOOOOEEEEEEEEEEEEEOOOOOOOOOOOOOOEEEEEEEEEEEEEOOOOEEEOOOOEEOOOOOOEEEOO
OOEEOOOOOOOEEOOOOOEEOOOOEEEEEEEEEEEEEOOOOOOOOOOOOOOEEEEEEEEEEEEEOOOOEEOOOOOEEOOOOOOOEEOO
OOEEOOOOOOOEEOOOOEEEOOOOEEEEEEEEEEEEEOOOOOOOOOOOOOOEEEEEEEEEEEEEOOOOEEEOOOOEEOOOOOOOEEOO
OOEEOOOOOOOEEOOEEEEEOOOOEEOOOOOOOEEEEOOOEEEEEEEEOOOEEEEOOOOOOOEEOOOOEEEEEOOEEOOOOOOOEEOO
OOEEEOOOOOOEEOOEEEEEOOOOEEOOOOOOOEEEEEOEEEEEEEEEEOEEEEEOOOOOOOEEOOOOEEEEEOOEEOOOOOOEEEOO
OOEEEEEEEEEEEEEEEEEEOOOOEEOOOOOEEEEEEEEEEEEEEEEEEEEEEEEEEOOOOOEEOOOOEEEEEEEEEEEEEEEEEEOO
OOEEEEEEEEEEEEEEEEEEOOOOEEOOOOOEEEEEEEEEEEEEEEEEEEEEEEEEEOOOOOEEOOOOEEEEEEEEEEEEEEEEEEOO
OOEEEEEEEEEEEEEEEEEEOOOOEEOOOOOEEEEEEEEEEEEEEEEEEEEEEEEEEOOOOOEEOOOOEEEEEEEEEEEEEEEEEEOO
OOEEEEEEEEEEEEEEEEEEOOOOEEOOOOOEEEEEEEEEEEEEEEEEEEEEEEEEEOOOOOEEOOOOEEEEEEEEEEEEEEEEEEOO
OOEEEOOOOOOEEOOEEEEEOOOOEEOOOOOOOEEEEEOEEEEEEEEEEOEEEEEOOOOOOOEEOOOOEEEEEOOEEOOOOOOEEEOO
OOEEOOOOOOOEEOOEEEEEOOOOEEOOOOOOOEEEEOOOEEEEEEEEOOOEEEEOOOOOOOEEOOOOEEEEEOOEEOOOOOOOEEOO
OOEEOOOOOOOEEOOOOEEEOOOOEEEEEEEEEEEEEOOOOOOOOOOOOOOEEEEEEEEEEEEEOOOOEEEOOOOEEOOOOOOOEEOO
OOEEOOOOOOOEEOOOOOEEOOOOEEEEEEEEEEEEEOOOOOOOOOOOOOOEEEEEEEEEEEEEOOOOEEOOOOOEEOOOOOOOEEOO
OOEEEOOOOOOEEOOOOEEEOOOOEEEEEEEEEEEEEOOOOOOOOOOOOOOEEEEEEEEEEEEEOOOOEEEOOOOEEOOOOOOEEEOO
OOEEEEEEEEEEEOOEEEEEEEEEEEOOOOOEEOOEEOOOEEOOOOEEOOOEEOOEEOOOOOEEEEEEEEEEEOOEEEEEEEEEEEOO
OOEEEEEEEEEEEOOEEEEEEEEEEEEOOOOEEOOEEEOEEEOOOOEEEOEEEOOEEOOOOEEEEEEEEEEEEOOEEEEEEEEEEEOO
OOEEOOOOOOOEEOOEEEOOOOOOEEEEEOOEEOOEEEEEEEEEEEEEEEEEEOOEEOOEEEEEOOOOOOEEEOOEEOOOOOOOEEOO
OOEEOOOOOOOEEOOEEEOOOOOOEEEEEOOEEOOEEEEEEEEEEEEEEEEEEOOEEOOEEEEEOOOOOOEEEOOEEOOOOOOOEEOO
OOEEOOOOOOOEEEEEEEEEEEEEEEEEEEEEEOOOOOOOEEOOOOEEOOOOOOOEEEEEEEEEEEEEEEEEEEEEEOOOOOOOEEOO
OOEEOOOOOOOEEEEEEEEEEEEEEEEEEEEEEOOOOOOOEEOOOOEEOOOOOOOEEEEEEEEEEEEEEEEEEEEEEOOOOOOOEEOO
OOEEOOOOOOOOOOOEEEOOOOOOOOEEEOOEEOOEEEEEEEOOOOEEEEEEEOOEEOOEEEOOOOOOOOEEEOOOOOOOOOOOEEOO
OOEEOOOOOOOOOOOEEEOOOOOOOOEEEOOEEOOEEEEEEEOOOOEEEEEEEOOEEOOEEEOOOOOOOOEEEOOOOOOOOOOOEEOO
OOEEOOOEEEEEEEEEEEEEEEOOOEEEEOOEEOOEEEOOOOOOOOOOOOEEEOOEEOOEEEEOOOEEEEEEEEEEEEEEEOOOEEOO
OOEEOOOEEEEEEEEEEEEEEEOOEEEEEOOEEOOEEOOOOOOOOOOOOOOEEOOEEOOEEEEEOOEEEEEEEEEEEEEEEOOOEEOO
OOEEOOOEEEEEEEEEEEEEEEOOOEEEOOOEEOOEEEOOOOOOOOOOOOEEEOOEEOOOEEEOOOEEEEEEEEEEEEEEEOOOEEOO
OOEEOOOEEOOOOOOOOOOOEEOOOOOOOOOEEOOEEEEEEEEEEEEEEEEEEOOEEOOOOOOOOOEEOOOOOOOOOOOEEOOOEEOO
OOEEEOEEEOOOOOOOOOOOEEOOOOOOOOOEEOOEEEEEEEEEEEEEEEEEEOOEEOOOOOOOOOEEOOOOOOOOOOOEEEOEEEOO
OOEEEEEEEEEEEEEEEEEEEEEEOOEEEEEEEEEEEOOOEEEEEEEEOOOEEEEEEEEEEEOOEEEEEEEEEEEEEEEEEEEEEEOO
OOEEEEEEEEEEEEEEEEEEEEEEOOEEEEEEEEEEEOOOEEEEEEEEOOOEEEEEEEEEEEOOEEEEEEEEEEEEEEEEEEEEEEOO
OOOOEEEOOOOEEOOOOOOOOOEEOOEEEOOOOOOEEOOOOOEEEEOOOOOEEOOOOOOEEEOOEEOOOOOOOOOEEOOOOEEEOOOO
OOOOEEEOOOOEEOOOOOOOOOEEOOEEEOOOOOOEEOOOOOEEEEOOOOOEEOOOOOOEEEOOEEOOOOOOOOOEEOOOOEEEOOOO
OOEEEEEEEOOEEOOOOOOOOOEEOOEEEOOEEEEEEEEOOOOOOOOOOEEEEEEEEOOEEEOOEEOOOOOOOOOEEOOEEEEEEEOO
OOEEEEEEEOOEEOOOOOOOOOEEOOEEEOOEEEEEEEEEOOOOOOOOEEEEEEEEEOOEEEOOEEOOOOOOOOOEEOOEEEEEEEOO
OOEEEEEEEEEEEOOOOOOOOOEEEEEEEOOEEOOOOEEEOOEEEEOOEEEOOOOEEOOEEEEEEEOOOOOOOOOEEEEEEEEEEEOO
OOEEEEEEEEEEEOOOOOOOOOEEEEEEEOOEEOOOOEEEOOEEEEOOEEEOOOOEEOOEEEEEEEOOOOOOOOOEEEEEEEEEEEOO
OOEEEEEEEEEEEOOOOOOOOOEEEEEEEOOEEOOOOEEEOEEEEEEOEEEOOOOEEOOEEEEEEEOOOOOOOOOEEEEEEEEEEEOO
OOEEEEEEEOOEEOOEEEEEEEEEOOEEEOOEEOOEEEEEEEEEEEEEEEEEEOOEEOOEEEOOEEEEEEEEEOOEEOOEEEEEEEOO
OOEEEEEEEOOEEOOOEEEEEEEEOOOEOOOEEOOEEEEEEEEEEEEEEEEEEOOEEOOOEOOOEEEEEEEEOOOEEOOEEEEEEEOO
OOOOOOOOOOOOOOOOOOOOOOOOOOOOOOOOOOOOOOOOOOOOOOOOOOOOOOOOOOOOOOOOOOOOOOOOOOOOOOOOOOOOOOOO
OOOOOOOOOOOOOOOOOOOOOOOOOOOOOOOOOOOOOOOOOOOOOOOOOOOOOOOOOOOOOOOOOOOOOOOOOOOOOOOOOOOOOOOO
