EEEEEEEEEEEEEEEEEEEEEEEEEEOEEEEEEEEEEEEEEEEE
EEEEEEEEEEEEEEEEEEEEEEEEEEOEEEEEEEEEEEEEEEEE
EEEEEEEEEEEEEEEEEEEEEEEEEEOEEEEEEEEEEEEEEEEE
EEEEEEEEEEEEEEEEEEEEEEEEEEOOEEEEEEEEEEEEEEEE
EEEEEEEEEEEEEEEEEEEEEEEEEEOOEEEEEEEEEEEEEEEE
EEEEEEEEEEEEEEEEEEEEEEEEEOOOOEEEEEEEEEEEEEEE
EEEEEEEEEEEEEEEEEEEEEEEEOOOOOOEEEEEEEEEEEEEE
EEEEEEEEEEEEEEEEEEEEEEEOOOOOOOOEEEEEEEEEEEEE
EEEEEEEEEEEEEEEEEEEEEEOOOOOOOOOOEEEEEEEEEEEE
EEEEEEEEEEEEEEEEEEEEEEOOOOOOOOOOOEEEEEEEEEEE
EEEEEEEEEEEEEEEEEEEEEEOOOOOOOOOOOOEEEEEEEEEE
EEEEEEEEEEEEEEEEEEEEEEOOOOOOOOOOOOOEEEEEEEEE
EEEEEEEEEEEEEEEEEEEEEEEOOOOOOOOOOOOOEEEEEEEE
EEEEEEEEEEEEEEEEEEEEEEEEOOOOOOOOOOOOOEEEEEEE
EEEEEEEEEEEEEEEEEEEEEEEEEOOOOOOOOOOOOOEEEEEE
EEEEEEEEEEEEEEEEEEEEEEEEEEOOOOOOOOOOOOOEEEEE
EEEEEEEEEEEEEEEEEEEEEEEEEEEEOOOOOOOOOOOEEEEE
EEEEEEEEEEEEEEEEEEEEEEEEEEEEEOOOOOOOOOEEEEEE
EEEEEEEEEEEEEEEEEEEEEEEEEEEEEEOOOOOOOEEEEEEE
EEEEEEEEEEEEEEEEEEEEEEEEEEEEEEEOOOOOEEEEEEEE
EEEEEEEEEEEEEEEEEEEEEEEEEEEEEEEEEEEEEEEEEEEE
EEEEEEEEEEEEEEEEEEEEEEEEEEEEEEEEEEEEEEEEEEEE
EEEEEEEEEEEEEEEEEEEEEEEEEEEEEEEEEEEEEEEEEEEE
EEEEEEEEEEEEEEEEEEEEEEEEEEEEEEEEEEEEEEEEEEEE
EEEEEEEEEEEEEEEEEEEEEEEEEEEEEEEEEEEEEEEEEEEE